NO ./path_to_the_north_texture
SO ./path_to_the_south_texture
WE ./path_to_the_west_texture
EA ./path_to_the_east_texture
F 220,100,0
C 225,30,0
        11111111111 1111111111111
        1000000000111000000000001
        1000001110000000000001111
        1001000000000000000000001
111111110111010000011100000000001
100000000011000001110111111111111
111101111111110111000000100011111
111101111111110111010100100011111
11000000110101011100000010001111
10000010000110000110000001101011
10000000000100001101010011110111
110000111010101111101111100N001
11110111 1110101111111011110001
11111111 111111111 1111111111111