NO ./path_to_the_south_texture
SO ./path_to_the_south_texture
WE ./path_to_the_west_texture
F 220,100,00
C 225,30,,,,,,0
EA ./path_to_the_east_texture
 1111111
 1000001
1N111111